Player,Pos,Age,Tm,G,GS,MP,FG,FGA,FG%,3P,3PA,3P%,2P,2PA,2P%,eFG%,FT,FTA,FT%,ORB,DRB,TRB,AST,STL,BLK,TOV,PF,PTS
Steven Adams,C,26,OKC,21,21,570,97,159,.610,0,1,.000,97,158,.614,.610,34,64,.531,65,131,196,62,10,27,30,39,228
Bam Adebayo,C,22,MIA,25,25,840,142,243,.584,1,8,.125,141,235,.600,.586,93,142,.655,65,200,265,110,34,29,74,66,378
LaMarcus Aldridge,C,34,SAS,22,22,730,167,330,.506,12,35,.343,155,295,.525,.524,68,82,.829,45,112,157,54,13,38,37,49,414
Nickeil Alexander-Walker,SG,21,NOP,22,0,301,49,148,.331,27,79,.342,22,69,.319,.422,11,16,.688,4,43,47,40,9,2,24,27,136
Grayson Allen,SG,24,MEM,13,0,246,38,92,.413,15,43,.349,23,49,.469,.495,15,17,.882,2,36,38,19,5,1,15,21,106
Jarrett Allen,C,21,BRK,24,21,636,119,178,.669,0,1,.000,119,177,.672,.669,67,111,.604,91,162,253,29,18,31,28,60,305
Kadeem Allen,SG,27,NYK,1,0,16,3,6,.500,3,4,.750,0,2,.000,.750,0,0,0,0,0,0,2,1,0,1,1,9
Al-Farouq Aminu,PF,29,ORL,18,2,380,25,86,.291,9,36,.250,16,50,.320,.343,19,29,.655,24,63,87,21,18,8,17,27,78
Kyle Anderson,PF,26,MEM,19,0,379,50,101,.495,4,16,.250,46,85,.541,.515,18,30,.600,20,66,86,45,14,12,17,32,122
Ryan Anderson,PF,31,HOU,2,0,14,2,7,.286,1,5,.200,1,2,.500,.357,0,0,0,0,7,7,2,1,0,1,1,5
Giannis Antetokounmpo,PF,25,MIL,25,25,785,287,511,.562,41,126,.325,246,385,.639,.602,163,273,.597,67,261,328,135,32,31,95,81,778
Kostas Antetokounmpo,PF,22,LAL,2,0,3,0,0,0,0,0,0,0,0,0,0,0,0,0,0,1,1,0,0,0,0,0,0
Thanasis Antetokounmpo,SF,27,MIL,5,0,25,6,10,.600,0,0,0,6,10,.600,.600,2,4,.500,3,0,3,4,0,0,2,3,14
Carmelo Anthony,PF,35,POR,12,12,379,73,176,.415,19,48,.396,54,128,.422,.469,30,37,.811,10,61,71,16,15,5,26,36,195
OG Anunoby,SF,22,TOR,23,23,692,102,202,.505,35,88,.398,67,114,.588,.592,20,33,.606,24,106,130,40,31,22,27,54,259
Ryan Arcidiacono,PG,25,CHI,27,0,431,36,96,.375,24,60,.400,12,36,.333,.500,17,22,.773,14,31,45,42,13,2,17,52,113
Trevor Ariza,SF,34,SAC,18,0,408,30,86,.349,21,63,.333,9,23,.391,.471,10,13,.769,8,61,69,22,18,3,14,30,91
D.J. Augustin,PG,32,ORL,25,6,641,76,203,.374,25,85,.294,51,118,.432,.436,52,59,.881,12,50,62,116,18,0,36,29,229
Deandre Ayton,C,21,PHO,1,1,33,9,14,.643,0,0,0,9,14,.643,.643,0,0,0,3,8,11,0,1,4,0,2,18
Dwayne Bacon,SG,24,CHO,20,10,382,49,156,.314,10,43,.233,39,113,.345,.346,22,31,.710,9,43,52,25,15,2,19,32,130
Marvin Bagley,PF,20,SAC,3,1,72,16,39,.410,0,2,.000,16,37,.432,.410,3,5,.600,9,14,23,0,1,4,4,6,35
Lonzo Ball,PG,22,NOP,18,12,507,67,180,.372,36,108,.333,31,72,.431,.472,12,19,.632,15,64,79,99,22,6,47,35,182
Mo Bamba,C,21,ORL,23,0,358,53,124,.427,17,46,.370,36,78,.462,.496,9,14,.643,31,87,118,10,6,31,27,47,132
J.J. Barea,PG,35,DAL,6,0,84,20,45,.444,10,17,.588,10,28,.357,.556,2,2,1.000,2,8,10,17,2,1,5,2,52
Harrison Barnes,PF,27,SAC,25,25,887,138,297,.465,34,94,.362,104,203,.512,.522,91,115,.791,27,105,132,58,21,5,40,32,401
RJ Barrett,SG,19,NYK,25,25,804,130,335,.388,25,83,.301,105,252,.417,.425,65,119,.546,27,108,135,77,31,12,57,60,350
Will Barton,SF,29,DEN,21,21,685,117,256,.457,40,98,.408,77,158,.487,.535,36,50,.720,33,109,142,73,22,9,26,44,310
Keita Bates-Diop,SF,24,MIN,13,0,241,35,68,.515,17,36,.472,18,32,.563,.640,6,10,.600,6,28,34,8,4,6,5,13,93
Nicolas Batum,SF,31,CHO,14,0,306,16,46,.348,9,33,.273,7,13,.538,.446,5,5,1.000,16,43,59,43,11,7,19,26,46
Aron Baynes,C,33,PHO,15,12,346,79,146,.541,27,68,.397,52,78,.667,.634,30,41,.732,23,60,83,40,4,10,16,60,215
Kent Bazemore,SF,30,POR,26,5,604,66,192,.344,32,95,.337,34,97,.351,.427,38,47,.809,10,99,109,42,22,18,36,77,202
Darius Bazley,PF,19,OKC,24,1,405,33,89,.371,15,44,.341,18,45,.400,.455,11,18,.611,8,83,91,12,8,10,20,22,92
Bradley Beal,SG,26,WAS,23,23,850,218,487,.448,58,176,.330,160,311,.514,.507,137,164,.835,24,80,104,162,21,6,81,62,631
Malik Beasley,SG,23,DEN,18,0,283,43,113,.381,22,54,.407,21,59,.356,.478,6,7,.857,5,21,26,18,8,2,17,19,114
Marco Belinelli,SG,33,SAS,22,0,360,43,129,.333,22,64,.344,21,65,.323,.419,15,21,.714,1,35,36,32,5,0,9,17,123
Jordan Bell,C,25,MIN,15,0,150,20,36,.556,0,5,.000,20,31,.645,.556,14,23,.609,16,35,51,10,1,7,14,11,54
DeAndre' Bembry,SG,25,ATL,26,4,610,73,150,.487,9,38,.237,64,112,.571,.517,18,37,.486,25,82,107,63,34,12,39,52,173
Dragan Bender,SF,22,MIL,3,0,29,6,8,.750,2,4,.500,4,4,1.000,.875,1,1,1.000,0,2,2,3,0,2,1,6,15
Dāvis Bertāns,PF,27,WAS,23,1,665,120,253,.474,92,198,.465,28,55,.509,.656,28,32,.875,22,86,108,36,14,14,14,58,360
Patrick Beverley,PG,31,LAC,24,24,707,69,172,.401,34,103,.330,35,69,.507,.500,14,23,.609,33,118,151,77,35,13,35,87,186
Khem Birch,C,27,ORL,16,11,375,28,57,.491,0,1,.000,28,56,.500,.491,13,26,.500,33,57,90,18,10,13,11,41,69
Goga Bitadze,C,20,IND,20,2,221,26,57,.456,4,14,.286,22,43,.512,.491,14,19,.737,16,36,52,14,1,19,10,33,70
Nemanja Bjelica,PF,31,SAC,25,24,658,112,236,.475,48,110,.436,64,126,.508,.576,19,21,.905,46,117,163,69,24,14,41,74,291
Eric Bledsoe,PG,30,MIL,26,26,693,147,308,.477,32,93,.344,115,215,.535,.529,65,80,.813,21,107,128,147,22,12,60,60,391
Bogdan Bogdanović,SG,27,SAC,23,0,634,117,283,.413,61,158,.386,56,125,.448,.521,34,50,.680,6,57,63,90,27,2,43,44,329
Bojan Bogdanović,SF,30,UTA,25,25,832,172,383,.449,82,180,.456,90,203,.443,.556,93,106,.877,16,93,109,50,17,4,72,47,519
Isaac Bonga,SF,20,WAS,18,12,279,25,52,.481,4,15,.267,21,37,.568,.519,10,13,.769,12,32,44,24,12,4,10,38,64
Devin Booker,SG,23,PHO,24,24,861,213,420,.507,54,133,.406,159,287,.554,.571,121,134,.903,15,79,94,154,15,8,91,72,601
Chris Boucher,PF,27,TOR,21,0,249,41,91,.451,11,34,.324,30,57,.526,.511,20,29,.690,41,47,88,10,7,15,8,28,113
Brian Bowen,SG,21,IND,3,0,10,1,4,.250,0,1,.000,1,3,.333,.250,0,0,0,0,1,1,0,0,1,0,0,2
Ky Bowman,PG,22,GSW,26,6,596,88,194,.454,27,65,.415,61,129,.473,.523,20,22,.909,13,56,69,70,23,3,31,55,223
Avery Bradley,SG,29,LAL,12,10,310,47,97,.485,8,32,.250,39,65,.600,.526,6,8,.750,8,29,37,18,10,1,12,31,108
Tony Bradley,C,22,UTA,18,2,164,33,54,.611,0,0,NA,33,54,.611,.611,11,16,.688,25,38,63,5,2,8,8,28,77
Jarrell Brantley,PF,23,UTA,2,0,9,0,0,NA,0,0,NA,0,0,NA,NA,0,0,NA,0,4,4,1,0,2,1,1,0
Ignas Brazdeikis,SF,21,NYK,7,0,47,5,20,.250,1,8,.125,4,12,.333,.275,3,4,.750,2,3,5,2,0,1,2,3,14
Mikal Bridges,SF,23,PHO,24,0,506,62,124,.500,12,40,.300,50,84,.595,.548,34,44,.773,21,67,88,26,32,8,20,44,170
Miles Bridges,SF,21,CHO,28,28,874,138,315,.438,48,126,.381,90,189,.476,.514,38,50,.760,37,112,149,50,14,22,47,59,362
Oshae Brissett,SF,21,TOR,4,0,17,1,3,.333,1,1,1.000,0,2,.000,.500,0,0,NA,0,1,1,1,1,0,1,0,3
Ryan Broekhoff,SG,29,DAL,5,0,27,4,8,.500,4,5,.800,0,3,.000,.750,0,0,NA,0,6,6,3,1,0,2,1,12
Malcolm Brogdon,PG,27,IND,22,22,696,152,320,.475,33,93,.355,119,227,.524,.527,92,99,.929,14,89,103,169,21,4,62,45,429
Dillon Brooks,SG,24,MEM,25,25,694,127,316,.402,44,119,.370,83,197,.421,.472,53,65,.815,25,60,85,49,27,9,35,93,351
Bruce Brown,SG,23,DET,25,21,655,73,173,.422,13,40,.325,60,133,.451,.460,25,43,.581,23,82,105,90,24,12,43,67,184
Charlie Brown,SG,22,ATL,4,0,16,1,3,.333,1,1,1.000,0,2,.000,.500,4,4,1.000,2,1,3,0,0,1,0,0,7
Jaylen Brown,SF,23,BOS,21,21,709,154,308,.500,40,107,.374,114,201,.567,.565,58,79,.734,21,124,145,47,23,7,38,71,406
Sterling Brown,SF,24,MIL,18,0,302,37,88,.420,19,46,.413,18,42,.429,.528,12,17,.706,13,72,85,25,12,2,17,23,105
Troy Brown,SG,20,WAS,20,11,442,60,133,.451,9,36,.250,51,97,.526,.485,19,25,.760,27,77,104,44,28,3,20,30,148
Jalen Brunson,PG,23,DAL,24,3,375,71,143,.497,15,46,.326,56,97,.577,.549,22,31,.710,13,42,55,63,11,0,21,28,179
Thomas Bryant,C,22,WAS,18,18,511,101,184,.549,10,35,.286,91,149,.611,.576,39,53,.736,42,111,153,48,8,18,24,44,251
Trey Burke,PG,27,PHI,9,0,152,25,58,.431,6,16,.375,19,42,.452,.483,8,11,.727,6,7,13,31,7,1,4,7,64
Alec Burks,SG,28,GSW,24,11,706,126,292,.432,35,98,.357,91,194,.469,.491,87,97,.897,18,91,109,70,26,6,35,54,374
Deonte Burton,SG,26,OKC,12,0,101,13,33,.394,5,17,.294,8,16,.500,.470,3,4,.750,3,18,21,4,1,1,4,11,34
Jimmy Butler,SF,30,MIA,21,21,739,128,295,.434,21,74,.284,107,221,.484,.469,158,191,.827,41,99,140,142,46,15,54,28,435
Bruno Caboclo,SF,24,MEM,16,0,174,27,62,.435,4,21,.190,23,41,.561,.468,2,3,.667,16,23,39,8,9,12,7,21,60
Kentavious Caldwell-Pope,SG,26,LAL,26,16,638,83,179,.464,32,81,.395,51,98,.520,.553,23,29,.793,14,40,54,46,21,4,24,44,221
DeMarre Carroll,SF,33,SAS,11,0,120,7,25,.280,3,12,.250,4,13,.308,.340,10,14,.714,7,22,29,10,2,2,9,17,27
Jevon Carter,PG,24,PHO,16,2,225,22,55,.400,14,34,.412,8,21,.381,.527,4,4,1.000,3,24,27,28,13,5,15,24,62
Vince Carter,SF,43,ATL,21,0,326,43,119,.361,23,80,.288,20,39,.513,.458,7,10,.700,4,37,41,20,7,6,14,34,116
Wendell Carter,C,20,CHI,27,27,795,124,220,.564,2,16,.125,122,204,.598,.568,72,101,.713,94,173,267,27,21,20,39,109,322
Michael Carter-Williams,SG,28,ORL,15,0,240,23,72,.319,5,24,.208,18,48,.375,.354,22,31,.710,17,32,49,30,13,8,16,22,73
Alex Caruso,PG,25,LAL,24,0,493,51,113,.451,18,49,.367,33,64,.516,.531,14,22,.636,4,48,52,43,25,7,26,37,134
Marquese Chriss,PF,22,GSW,26,1,472,69,144,.479,4,20,.200,65,124,.524,.493,51,63,.810,42,93,135,53,19,27,37,53,193
Gary Clark,PF,25,HOU,10,0,118,15,36,.417,11,30,.367,4,6,.667,.569,3,3,1.000,6,18,24,6,1,4,1,9,44
Brandon Clarke,PF,23,MEM,19,2,403,97,152,.638,12,24,.500,85,128,.664,.678,22,28,.786,24,89,113,23,9,19,20,33,228
Jordan Clarkson,SG,27,CLE,25,0,570,121,284,.426,48,138,.348,73,146,.500,.511,68,76,.895,18,41,59,63,14,7,36,30,358
Nicolas Claxton,PF,20,BRK,9,0,119,11,21,.524,0,5,.000,11,16,.688,.524,5,12,.417,8,14,22,11,1,5,6,10,27
Chris Clemons,SG,22,HOU,18,0,146,27,65,.415,19,51,.373,8,14,.571,.562,3,4,.750,2,8,10,6,3,2,6,14,76
John Collins,PF,22,ATL,5,5,161,32,61,.525,9,19,.474,23,42,.548,.598,12,17,.706,10,34,44,8,5,10,7,17,85
Zach Collins,PF,22,POR,3,3,86,9,19,.474,3,7,.429,6,12,.500,.553,6,6,1.000,4,8,12,6,0,2,6,11,27
Mike Conley,PG,32,UTA,21,21,628,97,263,.369,40,107,.374,57,156,.365,.445,58,73,.795,16,57,73,96,15,4,44,45,292
Pat Connaughton,SG,27,MIL,24,0,415,48,98,.490,18,55,.327,30,43,.698,.582,13,17,.765,11,83,94,44,8,11,15,24,127
Quinn Cook,PG,26,LAL,20,0,267,42,98,.429,12,35,.343,30,63,.476,.490,4,5,.800,4,19,23,30,6,1,16,12,100
Robert Covington,PF,29,MIN,24,24,674,101,226,.447,50,140,.357,51,86,.593,.558,47,53,.887,17,110,127,26,34,20,38,75,299
Allen Crabbe,SG,27,ATL,14,1,280,31,77,.403,15,48,.313,16,29,.552,.500,7,9,.778,7,28,35,14,8,3,6,14,84
Torrey Craig,SF,29,DEN,16,2,214,18,48,.375,5,22,.227,13,26,.500,.427,4,9,.444,11,26,37,15,5,12,6,28,45
Jae Crowder,SF,29,MEM,25,25,778,87,229,.380,53,163,.325,34,66,.515,.496,43,57,.754,17,138,155,71,25,9,37,53,270
Jarrett Culver,SG,20,MIN,25,15,582,85,229,.371,23,92,.250,62,137,.453,.421,23,53,.434,27,56,83,55,21,12,31,51,216
Seth Curry,SG,29,DAL,22,9,478,67,145,.462,37,90,.411,30,55,.545,.590,31,34,.912,11,36,47,38,14,4,19,40,202
Stephen Curry,PG,31,GSW,4,4,112,27,66,.409,9,37,.243,18,29,.621,.477,18,18,1.000,4,16,20,26,5,2,15,10,81
Troy Daniels,SG,28,LAL,20,0,278,34,92,.370,24,69,.348,10,23,.435,.500,4,7,.571,4,24,28,7,7,1,6,14,96
Anthony Davis,PF,26,LAL,25,25,866,239,478,.500,30,88,.341,209,390,.536,.531,177,205,.863,61,169,230,82,37,66,55,58,685
Terence Davis,SG,22,TOR,24,0,375,58,121,.479,27,65,.415,31,56,.554,.591,16,17,.941,14,56,70,44,11,6,20,43,159
Dewayne Dedmon,C,30,SAC,21,4,305,42,103,.408,11,48,.229,31,55,.564,.461,11,13,.846,26,59,85,8,9,11,31,55,106
Matthew Dellavedova,PG,29,CLE,23,0,306,19,68,.279,4,39,.103,15,29,.517,.309,15,16,.938,7,25,32,53,9,1,16,35,57
DeMar DeRozan,SF,30,SAS,24,24,826,197,389,.506,5,14,.357,192,375,.512,.513,114,142,.803,13,121,134,115,24,11,60,69,513
Cheick Diallo,C,23,PHO,17,0,174,41,59,.695,1,1,1.000,40,58,.690,.703,15,17,.882,14,38,52,9,2,4,8,20,98
Hamidou Diallo,SF,21,OKC,12,1,256,46,92,.500,2,13,.154,44,79,.557,.511,11,18,.611,14,32,46,10,18,4,14,29,105
Gorgui Dieng,C,30,MIN,21,2,260,36,86,.419,9,30,.300,27,56,.482,.471,12,16,.750,17,66,83,21,14,21,14,31,93
Spencer Dinwiddie,SG,26,BRK,24,13,716,164,382,.429,45,147,.306,119,235,.506,.488,125,149,.839,5,67,72,148,21,11,65,83,498
Donte DiVincenzo,SG,23,MIL,23,10,484,72,168,.429,29,83,.349,43,85,.506,.515,22,28,.786,18,75,93,38,33,3,27,37,195
Luka Dončić,PG,20,DAL,24,24,803,236,490,.482,76,232,.328,160,258,.620,.559,182,227,.802,32,206,238,222,30,3,108,57,730
Luguentz Dort,SG,20,OKC,4,0,69,5,15,.333,0,8,.000,5,7,.714,.333,3,5,.600,0,6,6,1,2,0,2,12,13
Damyean Dotson,SG,25,NYK,22,0,353,51,124,.411,24,75,.320,27,49,.551,.508,10,14,.714,4,35,39,25,10,4,11,20,136
Sekou Doumbouya,SF,19,DET,4,0,11,3,6,.500,0,1,.000,3,5,.600,.500,0,1,.000,0,2,2,0,0,0,0,3,6
Goran Dragić,PG,33,MIA,18,1,517,97,208,.466,39,96,.406,58,112,.518,.560,54,76,.711,6,52,58,90,12,4,47,32,287
Andre Drummond,C,26,DET,25,25,845,185,339,.546,0,13,.000,185,326,.567,.546,72,114,.632,115,301,416,73,43,46,89,96,442
Jared Dudley,SF,34,LAL,17,0,138,9,21,.429,9,15,.600,0,6,.000,.643,2,2,1.000,2,14,16,12,7,1,2,13,29
Kris Dunn,PG,25,CHI,27,8,589,77,186,.414,11,60,.183,66,126,.524,.444,15,21,.714,14,72,86,78,52,9,28,94,180
Carsen Edwards,SG,21,BOS,21,0,236,27,84,.321,17,51,.333,10,33,.303,.423,11,13,.846,5,31,36,17,7,2,12,22,82
Henry Ellenson,PF,23,BRK,1,0,3,0,0,0,0,0,0,0,0,0,0,0,0,0,0,0,0,0,0,0,0,0,0
Wayne Ellington,SG,32,NYK,18,1,257,26,81,.321,21,69,.304,5,12,.417,.451,4,6,.667,1,28,29,16,5,2,12,20,77
Joel Embiid,C,25,PHI,22,22,675,159,345,.461,24,76,.316,135,269,.502,.496,159,196,.811,53,218,271,73,20,29,72,77,501
James Ennis,SF,29,PHI,27,0,471,68,136,.500,25,60,.417,43,76,.566,.592,36,47,.766,29,60,89,25,14,8,18,55,197
Derrick Favors,C,28,NOP,10,8,204,40,68,.588,1,2,.500,39,66,.591,.596,2,7,.286,34,54,88,19,5,4,14,22,83
Terrance Ferguson,SF,21,OKC,19,19,497,39,92,.424,23,65,.354,16,27,.593,.549,7,9,.778,11,25,36,19,10,6,14,57,108
Bruno Fernando,C,21,ATL,25,0,296,41,77,.532,4,16,.250,37,61,.607,.558,16,25,.640,28,45,73,27,6,9,23,39,102
Yogi Ferrell,PG,26,SAC,21,0,291,43,96,.448,9,33,.273,34,63,.540,.495,27,31,.871,4,23,27,37,10,1,14,17,122
Dorian Finney-Smith,PF,26,DAL,24,21,649,75,160,.469,30,89,.337,45,71,.634,.563,24,34,.706,45,76,121,28,14,10,24,44,204
Bryn Forbes,SG,26,SAS,24,24,636,106,257,.412,55,155,.355,51,102,.500,.519,31,37,.838,7,52,59,47,12,0,17,46,298
Evan Fournier,SG,27,ORL,25,25,766,176,364,.484,73,163,.448,103,201,.512,.584,80,96,.833,4,68,72,80,24,4,51,57,505
De'Aaron Fox,PG,22,SAC,9,9,288,55,128,.430,10,30,.333,45,98,.459,.469,44,62,.710,5,31,36,63,7,5,37,27,164
Danilo Gallinari,PF,31,OKC,23,23,702,128,289,.443,63,158,.399,65,131,.496,.552,97,107,.907,12,122,134,49,16,3,34,36,416
Langston Galloway,SG,28,DET,25,6,682,96,216,.444,61,143,.427,35,73,.479,.586,47,52,.904,9,44,53,38,14,8,19,30,300
Darius Garland,PG,20,CLE,25,25,695,102,269,.379,42,115,.365,60,154,.390,.457,23,27,.852,10,36,46,71,16,0,64,34,269
Marc Gasol,C,35,TOR,24,24,693,53,152,.349,28,79,.354,25,73,.342,.441,19,26,.731,21,137,158,87,18,28,33,81,153
Rudy Gay,PF,33,SAS,24,5,554,100,218,.459,21,76,.276,79,142,.556,.507,48,54,.889,31,106,137,46,12,14,40,34,269
Paul George,SF,29,LAC,16,16,489,128,287,.446,65,163,.399,63,124,.508,.559,73,80,.913,8,91,99,60,23,7,56,43,394
Taj Gibson,C,34,NYK,24,18,397,52,104,.500,2,10,.200,50,94,.532,.510,9,15,.600,44,64,108,30,16,8,17,53,115
Aaron Gordon,PF,24,ORL,22,22,690,114,262,.435,28,88,.318,86,174,.494,.489,52,72,.722,39,117,156,65,15,11,32,46,308
Eric Gordon,SG,31,HOU,9,2,265,34,110,.309,21,74,.284,13,36,.361,.405,9,14,.643,3,14,17,7,5,2,12,21,98
Devonte' Graham,PG,24,CHO,28,18,950,178,433,.411,105,249,.422,73,184,.397,.532,95,116,.819,29,76,105,212,22,6,87,51,556
Treveon Graham,SG,26,MIN,24,17,497,47,139,.338,13,64,.203,34,75,.453,.385,19,24,.792,23,54,77,24,14,2,14,50,126
Jerami Grant,PF,25,DEN,23,0,514,82,181,.453,32,81,.395,50,100,.500,.541,26,46,.565,11,68,79,24,11,14,18,42,222
Danny Green,SG,32,LAL,26,26,664,77,182,.423,49,130,.377,28,52,.538,.558,11,14,.786,17,81,98,33,32,14,25,60,214
Draymond Green,PF,29,GSW,17,17,490,56,137,.409,12,45,.267,44,92,.478,.453,31,43,.721,7,98,105,101,29,11,39,44,155
JaMychal Green,PF,29,LAC,22,0,469,55,133,.414,34,90,.378,21,43,.488,.541,18,21,.857,29,116,145,10,13,7,20,54,162
Javonte Green,SF,26,BOS,18,0,120,21,35,.600,3,10,.300,18,25,.720,.643,2,5,.400,3,14,17,4,4,3,3,12,47
Jeff Green,PF,33,UTA,26,2,490,67,172,.390,33,97,.340,34,75,.453,.485,47,58,.810,10,58,68,16,10,10,27,45,214
Blake Griffin,PF,30,DET,13,13,382,72,189,.381,23,81,.284,49,108,.454,.442,61,79,.772,12,50,62,44,5,4,33,19,228
Marko Guduric,SG,24,MEM,25,0,365,46,122,.377,18,62,.290,28,60,.467,.451,13,15,.867,12,38,50,34,9,5,27,24,123
Rui Hachimura,PF,21,WAS,23,23,684,139,289,.481,9,45,.200,130,244,.533,.497,44,51,.863,38,101,139,40,18,3,19,54,331
Devon Hall,SG,24,OKC,5,0,20,1,5,.200,0,2,.000,1,3,.333,.200,3,4,.750,0,1,1,3,0,0,1,1,5
Tim Hardaway,SG,27,DAL,24,11,596,104,244,.426,56,152,.368,48,92,.522,.541,41,50,.820,7,47,54,41,14,3,14,46,305
James Harden,SG,30,HOU,25,25,945,277,617,.449,127,350,.363,150,267,.562,.552,301,341,.883,24,123,147,187,50,18,126,83,982
Maurice Harkless,SF,26,LAC,27,17,640,64,131,.489,16,46,.348,48,85,.565,.550,17,30,.567,27,73,100,29,29,19,26,80,161
Montrezl Harrell,C,26,LAC,27,2,793,208,353,.589,0,10,.000,208,343,.606,.589,89,141,.631,77,129,206,55,19,32,47,66,505
Gary Harris,SG,25,DEN,23,23,738,94,224,.420,36,98,.367,58,126,.460,.500,27,34,.794,12,56,68,46,26,7,22,50,251
Joe Harris,SF,28,BRK,24,24,757,130,272,.478,67,153,.438,63,119,.529,.601,22,27,.815,22,71,93,50,17,8,33,61,349
Tobias Harris,PF,27,PHI,27,27,926,211,430,.491,38,117,.325,173,313,.553,.535,75,94,.798,20,168,188,88,24,22,51,70,535
Shaquille Harrison,SF,26,CHI,16,4,141,20,49,.408,3,10,.300,17,39,.436,.439,11,18,.611,6,24,30,22,8,4,6,16,54
Josh Hart,SF,24,NOP,19,4,520,70,167,.419,42,115,.365,28,52,.538,.545,28,36,.778,19,94,113,29,20,7,24,56,210
Isaiah Hartenstein,C,21,HOU,9,0,103,11,16,.688,0,1,.000,11,15,.733,.688,9,11,.818,8,18,26,5,3,4,6,17,31
Jaxson Hayes,C,19,NOP,23,10,484,79,127,.622,0,3,.000,79,124,.637,.622,51,79,.646,43,63,106,16,19,24,19,71,209
Gordon Hayward,SF,29,BOS,11,11,337,80,144,.556,15,38,.395,65,106,.613,.608,18,23,.783,8,59,67,45,8,3,20,20,193
John Henson,PF,29,CLE,7,0,84,15,26,.577,0,5,.000,15,21,.714,.577,3,11,.273,6,9,15,8,5,7,7,11,33
Dewan Hernandez,C,23,TOR,3,0,9,1,5,.200,0,1,.000,1,4,.250,.200,2,2,1.000,2,5,7,0,1,0,1,5,4
Juan Hernangómez,PF,24,DEN,15,0,210,21,57,.368,12,37,.324,9,20,.450,.474,5,9,.556,8,28,36,11,1,3,9,14,59
Willy Hernangómez,C,25,CHO,8,0,60,9,22,.409,2,6,.333,7,16,.438,.455,4,8,.500,9,12,21,2,1,3,5,4,24
Tyler Herro,SG,20,MIA,24,3,683,120,279,.430,48,130,.369,72,149,.483,.516,39,47,.830,6,86,92,46,18,3,47,32,327
Mario Hezonja,PF,24,POR,23,4,398,35,98,.357,10,31,.323,25,67,.373,.408,22,27,.815,16,88,104,22,13,2,20,51,102
Buddy Hield,SG,27,SAC,25,25,862,202,470,.430,100,266,.376,102,204,.500,.536,46,54,.852,26,103,129,71,20,9,64,66,550
George Hill,PG,33,MIL,24,0,513,79,145,.545,37,69,.536,42,76,.553,.672,34,40,.850,25,48,73,77,20,2,19,40,229
Solomon Hill,SF,28,MEM,23,1,473,51,128,.398,26,72,.361,25,56,.446,.500,11,18,.611,14,61,75,44,25,2,21,38,139
Aaron Holiday,PG,23,IND,24,9,511,86,207,.415,35,89,.393,51,118,.432,.500,15,18,.833,9,51,60,62,21,2,30,35,222
Jrue Holiday,SG,29,NOP,24,24,861,185,414,.447,41,126,.325,144,288,.500,.496,46,68,.676,31,91,122,162,43,18,81,58,457
Justin Holiday,SG,30,IND,26,2,657,71,173,.410,41,106,.387,30,67,.448,.529,19,23,.826,13,88,101,39,28,16,16,45,202
Rondae Hollis-Jefferson,SF,25,TOR,17,0,344,58,108,.537,1,5,.200,57,103,.553,.542,28,39,.718,43,50,93,24,13,6,22,32,145
Danuel House,SF,26,HOU,19,17,567,69,154,.448,43,106,.406,26,48,.542,.588,32,39,.821,21,56,77,26,20,12,18,41,213
Dwight Howard,C,34,LAL,26,0,516,69,96,.719,1,3,.333,68,93,.731,.724,35,69,.507,56,127,183,19,10,34,29,93,174
Kevin Huerter,SG,21,ATL,15,7,345,43,107,.402,24,67,.358,19,40,.475,.514,15,19,.789,7,41,48,50,11,6,22,29,125
De'Andre Hunter,SF,22,ATL,25,24,794,114,281,.406,44,124,.355,70,157,.446,.484,49,64,.766,13,86,99,47,16,7,40,63,321
Chandler Hutchison,SF,23,CHI,9,6,154,20,44,.455,5,12,.417,15,32,.469,.511,19,29,.655,1,32,33,8,5,2,12,12,64
Serge Ibaka,C,30,TOR,14,0,309,65,150,.433,12,35,.343,53,115,.461,.473,29,35,.829,24,72,96,18,6,13,29,35,171
Ersan İlyasova,PF,32,MIL,23,1,374,66,129,.512,19,57,.333,47,72,.653,.585,27,33,.818,30,83,113,16,11,7,6,39,178
Joe Ingles,SF,32,UTA,26,6,737,74,187,.396,39,117,.333,35,70,.500,.500,28,36,.778,7,99,106,110,26,2,46,63,215
Brandon Ingram,PF,22,NOP,22,22,740,198,401,.494,50,123,.407,148,278,.532,.556,109,129,.845,17,138,155,80,16,18,63,70,555
Kyrie Irving,PG,27,BRK,11,11,372,112,252,.444,31,91,.341,81,161,.503,.506,59,63,.937,10,49,59,79,12,6,26,32,314
Jonathan Isaac,SF,22,ORL,23,23,710,111,246,.451,26,78,.333,85,168,.506,.504,40,49,.816,39,125,164,31,28,63,36,55,288
Wesley Iwundu,SF,25,ORL,13,3,182,14,44,.318,1,12,.083,13,32,.406,.330,15,18,.833,5,22,27,11,7,3,6,10,44
Frank Jackson,PG,21,NOP,22,1,321,52,140,.371,20,65,.308,32,75,.427,.443,26,32,.813,5,25,30,22,9,1,21,33,150
Jaren Jackson,C,20,MEM,24,24,657,153,325,.471,58,146,.397,95,179,.531,.560,59,76,.776,27,89,116,36,12,29,47,102,423
Justin Jackson,PF,24,DAL,23,0,331,55,122,.451,23,60,.383,32,62,.516,.545,10,13,.769,10,47,57,10,5,2,4,26,143
Reggie Jackson,PG,29,DET,2,2,36,4,11,.364,1,5,.200,3,6,.500,.409,1,1,1.000,1,4,5,8,0,0,1,2,10
Justin James,SG,23,SAC,11,0,140,18,44,.409,3,14,.214,15,30,.500,.443,1,6,.167,2,18,20,9,4,6,5,11,40
LeBron James,PG,35,LAL,26,26,900,261,523,.499,57,157,.363,204,366,.557,.554,95,138,.688,27,157,184,281,34,13,103,46,674
Ty Jerome,PG,22,PHO,6,0,77,6,24,.250,3,9,.333,3,15,.200,.313,2,2,1.000,0,10,10,13,9,0,6,10,17
Alize Johnson,SF,23,IND,8,0,37,5,11,.455,0,0,0,5,11,.455,.455,3,4,.750,6,6,12,2,0,0,1,4,13
B.J. Johnson,SF,24,ORL,1,0,3,0,0,0,0,0,0,0,0,0,0,0,0,0,0,0,0,0,0,0,0,0,0
Cameron Johnson,PF,23,PHO,22,0,445,70,161,.435,44,108,.407,26,53,.491,.571,19,21,.905,23,46,69,19,13,7,16,38,203
James Johnson,PF,32,MIA,6,0,68,8,18,.444,2,9,.222,6,9,.667,.500,2,4,.500,2,9,11,4,3,2,4,5,20
Keldon Johnson,SF,20,SAS,1,0,2,0,1,.000,0,0,0,0,1,.000,.000,0,0,0,0,0,0,0,0,0,0,0,0
Stanley Johnson,PF,23,TOR,5,0,19,3,9,.333,1,4,.250,2,5,.400,.389,0,0,0,2,5,7,0,1,0,4,6,7
Tyler Johnson,SG,27,PHO,19,3,364,44,111,.396,18,55,.327,26,56,.464,.477,18,24,.750,5,30,35,41,6,6,19,28,124
Nikola Jokić,C,24,DEN,23,23,714,152,324,.469,22,92,.239,130,232,.560,.503,47,60,.783,49,181,230,145,23,13,57,72,373
Damian Jones,C,24,ATL,25,17,464,78,109,.716,2,5,.400,76,104,.731,.725,31,47,.660,40,60,100,19,11,23,17,88,189
Derrick Jones,SF,22,MIA,11,0,194,24,49,.490,4,15,.267,20,34,.588,.531,15,21,.714,6,25,31,13,10,3,6,25,67
Tyus Jones,PG,23,MEM,25,6,508,62,159,.390,9,39,.231,53,120,.442,.418,19,26,.731,1,38,39,121,22,3,31,22,152
Cory Joseph,PG,28,SAC,25,16,659,60,162,.370,14,50,.280,46,112,.411,.414,16,16,1.000,12,54,66,95,20,13,32,51,150
Mfiondu Kabengele,C,22,LAC,9,0,38,8,19,.421,5,11,.455,3,8,.375,.553,3,3,1.000,1,6,7,1,1,1,1,4,24
Frank Kaminsky,C,26,PHO,24,11,567,94,211,.445,30,86,.349,64,125,.512,.517,47,70,.671,24,102,126,53,10,9,24,54,265
Enes Kanter,C,27,BOS,17,3,277,55,91,.604,0,2,.000,55,89,.618,.604,24,37,.649,43,59,102,18,11,10,12,26,134
Luke Kennard,SG,23,DET,24,21,788,131,299,.438,61,156,.391,70,143,.490,.540,60,67,.896,6,73,79,100,12,5,33,56,383
Michael Kidd-Gilchrist,PF,26,CHO,6,0,96,12,36,.333,3,12,.250,9,24,.375,.375,4,5,.800,7,19,26,6,0,2,5,12,31
Maxi Kleber,C,28,DAL,23,5,552,61,144,.424,32,86,.372,29,58,.500,.535,28,31,.903,38,88,126,22,6,15,16,43,182
Brandon Knight,PG,28,CLE,8,0,95,14,40,.350,10,31,.323,4,9,.444,.475,2,6,.333,1,7,8,15,4,0,6,9,40
Kevin Knox,SF,20,NYK,25,3,492,59,165,.358,30,90,.333,29,75,.387,.448,32,49,.653,10,61,71,31,12,11,18,40,180
Furkan Korkmaz,SG,22,PHI,26,11,565,77,179,.430,41,113,.363,36,66,.545,.545,17,21,.810,4,56,60,23,8,5,19,39,212
Luke Kornet,C,24,CHI,14,0,142,15,48,.313,5,27,.185,10,21,.476,.365,5,5,1.000,6,16,22,6,2,10,3,13,40
Kyle Korver,SF,38,MIL,21,0,324,37,101,.366,30,84,.357,7,17,.412,.515,9,11,.818,6,29,35,17,10,4,18,21,113
Rodions Kurucs,PF,21,BRK,10,0,99,9,23,.391,3,7,.429,6,16,.375,.457,2,6,.333,5,17,22,1,5,0,12,16,23
Kyle Kuzma,PF,24,LAL,20,1,461,81,187,.433,32,89,.360,49,98,.500,.519,27,39,.692,8,60,68,17,6,8,35,34,221
Skal Labissière,C,23,POR,26,0,442,62,113,.549,2,9,.222,60,104,.577,.558,15,22,.682,52,80,132,30,6,24,24,68,141
Jeremy Lamb,SG,27,IND,17,17,535,97,209,.464,20,66,.303,77,143,.538,.512,39,48,.813,10,73,83,45,17,9,23,37,253
Damion Lee,SG,27,GSW,13,0,282,45,109,.413,15,43,.349,30,66,.455,.482,32,39,.821,10,37,47,20,8,0,13,20,137
Alex Len,C,26,ATL,25,9,434,81,152,.533,7,31,.226,74,121,.612,.556,35,51,.686,40,84,124,26,14,20,21,52,204
Kawhi Leonard,SF,28,LAC,20,20,630,179,398,.450,35,98,.357,144,300,.480,.494,123,140,.879,22,136,158,102,36,14,72,41,516
Meyers Leonard,PF,27,MIA,25,25,451,57,98,.582,22,44,.500,35,54,.648,.694,5,9,.556,8,94,102,24,7,11,19,51,141
Caris LeVert,SG,25,BRK,9,9,284,59,140,.421,13,36,.361,46,104,.442,.468,20,31,.645,10,35,45,36,6,1,31,20,151
Damian Lillard,PG,29,POR,24,24,879,196,442,.443,79,218,.362,117,224,.522,.533,160,176,.909,12,94,106,180,24,10,68,47,631
Nassir Little,PF,19,POR,18,3,270,31,76,.408,5,30,.167,26,46,.565,.441,15,22,.682,20,42,62,12,8,7,9,35,82
Kevon Looney,C,23,GSW,7,3,79,9,23,.391,1,2,.500,8,21,.381,.413,3,5,.600,11,12,23,2,2,2,6,13,22
Brook Lopez,C,31,MIL,24,24,628,82,208,.394,35,117,.299,47,91,.516,.478,43,48,.896,15,106,121,35,16,56,25,56,242
Robin Lopez,C,31,MIL,26,2,370,52,110,.473,13,44,.295,39,66,.591,.532,13,21,.619,27,46,73,17,4,17,31,43,130
Kevin Love,PF,31,CLE,21,21,645,110,250,.440,44,122,.361,66,128,.516,.528,80,93,.860,23,204,227,54,13,8,57,30,344
Kyle Lowry,PG,33,TOR,13,13,483,72,176,.409,37,107,.346,35,69,.507,.514,67,74,.905,8,54,62,89,15,5,40,37,248
Timothé Luwawu-Cabarrot,SG,24,BRK,2,0,6,0,2,.000,0,1,.000,0,1,.000,.000,1,2,.500,0,0,0,0,0,0,0,0,1
Trey Lyles,PF,24,SAS,24,14,402,39,91,.429,19,51,.373,20,40,.500,.533,5,9,.556,32,110,142,29,7,7,19,29,102
Daryl Macon,SG,24,MIA,4,0,14,1,3,.333,1,2,.500,0,1,.000,.500,0,0,0,0,0,0,1,0,0,2,1,3
Josh Magette,PG,30,ORL,3,0,10,2,6,.333,0,0,0,2,6,.333,.333,1,2,.500,1,2,3,2,2,0,3,0,5
Ian Mahinmi,C,33,WAS,3,0,51,9,14,.643,0,1,.000,9,13,.692,.643,7,10,.700,6,8,14,2,1,5,4,8,25
Thon Maker,C,22,DET,23,0,231,24,44,.545,7,14,.500,17,30,.567,.625,16,31,.516,10,27,37,9,6,14,11,31,71
Terance Mann,SG,23,LAC,21,4,187,19,39,.487,2,9,.222,17,30,.567,.513,7,8,.875,3,21,24,26,6,3,12,24,47
Boban Marjanović,C,31,DAL,10,1,131,31,56,.554,0,1,.000,31,55,.564,.554,13,16,.813,15,40,55,7,2,3,9,18,75
Lauri Markkanen,PF,22,CHI,27,27,803,124,317,.391,53,163,.325,71,154,.461,.475,86,106,.811,28,149,177,45,23,13,50,55,387
Caleb Martin,SF,24,CHO,4,0,28,3,10,.300,0,3,.000,3,7,.429,.300,1,3,.333,1,4,5,3,1,2,3,3,7
Cody Martin,SF,24,CHO,19,0,232,19,52,.365,3,23,.130,16,29,.552,.394,16,23,.696,9,33,42,22,14,2,11,22,57
Wesley Matthews,SG,33,MIL,26,26,623,72,163,.442,43,111,.387,29,52,.558,.574,23,27,.852,5,55,60,36,14,2,19,35,210
Patrick McCaw,SF,24,TOR,3,0,50,3,7,.429,1,3,.333,2,4,.500,.500,1,2,.500,2,4,6,3,3,0,4,5,8
CJ McCollum,SG,28,POR,26,26,942,223,499,.447,67,178,.376,156,321,.486,.514,43,54,.796,20,93,113,95,19,22,51,73,556
T.J. McConnell,PG,27,IND,24,0,419,70,144,.486,1,4,.250,69,140,.493,.490,12,13,.923,10,53,63,116,14,5,34,27,153
Rodney McGruder,SG,28,LAC,16,2,275,23,63,.365,11,37,.297,12,26,.462,.452,3,8,.375,12,27,39,12,4,3,7,30,60
Alfonzo McKinnie,SF,27,CLE,17,0,175,17,50,.340,8,25,.320,9,25,.360,.420,7,11,.636,10,26,36,3,6,3,8,20,49
Jordan McLaughlin,PG,23,MIN,4,0,57,4,15,.267,1,8,.125,3,7,.429,.300,2,2,1.000,1,6,7,8,1,0,4,4,11
Ben McLemore,SG,26,HOU,25,7,575,84,203,.414,64,175,.366,20,28,.714,.571,25,29,.862,9,51,60,27,15,7,20,50,257
Jordan McRae,SG,28,WAS,13,0,235,43,91,.473,13,33,.394,30,58,.517,.544,17,19,.895,3,28,31,36,8,4,14,26,116
Nicolò Melli,C,29,NOP,23,3,348,41,102,.402,22,70,.314,19,32,.594,.510,19,24,.792,14,46,60,25,14,4,18,42,123
De'Anthony Melton,PG,21,MEM,14,0,213,29,72,.403,6,21,.286,23,51,.451,.444,16,18,.889,10,37,47,42,17,4,18,26,80
Khris Middleton,SF,28,MIL,19,16,530,131,266,.492,40,100,.400,91,166,.548,.568,46,51,.902,13,93,106,64,17,2,37,45,348
C.J. Miles,SG,32,WAS,10,0,161,19,59,.322,11,35,.314,8,24,.333,.415,15,20,.750,4,8,12,12,10,4,4,14,64
Malcolm Miller,SF,26,TOR,10,1,57,6,12,.500,5,10,.500,1,2,.500,.708,1,6,.167,0,7,7,4,0,2,2,6,18
Patty Mills,PG,31,SAS,24,1,566,93,203,.458,49,117,.419,44,86,.512,.579,31,39,.795,4,29,33,55,21,5,24,40,266
Paul Millsap,PF,34,DEN,23,23,582,100,210,.476,25,55,.455,75,155,.484,.536,65,74,.878,45,89,134,28,20,19,29,61,290
Shake Milton,SG,23,PHI,9,0,82,12,35,.343,4,19,.211,8,16,.500,.400,7,9,.778,1,7,8,7,1,0,12,13,35
Donovan Mitchell,SG,23,UTA,26,26,902,240,535,.449,59,163,.362,181,372,.487,.504,111,133,.835,23,100,123,95,31,8,62,59,650
Emmanuel Mudiay,PG,23,UTA,23,0,371,63,136,.463,11,34,.324,52,102,.510,.504,29,37,.784,7,52,59,55,6,6,39,40,166
Dejounte Murray,PG,23,SAS,21,13,469,78,174,.448,5,26,.192,73,148,.493,.463,39,49,.796,25,102,127,85,35,6,48,47,200
Jamal Murray,PG,22,DEN,23,23,722,149,344,.433,38,112,.339,111,232,.478,.488,58,65,.892,17,81,98,103,33,8,51,39,394
Džanan Musa,SF,20,BRK,19,0,294,30,93,.323,9,47,.191,21,46,.457,.371,23,31,.742,9,40,49,24,9,1,23,17,92
Mike Muscala,C,28,OKC,15,0,166,18,58,.310,12,44,.273,6,14,.429,.414,7,8,.875,6,29,35,14,4,3,6,20,55
Sviatoslav Mykhailiuk,SF,22,DET,20,1,337,37,86,.430,29,63,.460,8,23,.348,.599,5,6,.833,4,20,24,26,8,1,17,23,108
Abdel Nader,SF,26,OKC,17,4,296,43,88,.489,21,45,.467,22,43,.512,.608,20,24,.833,6,28,34,9,6,6,17,25,127
Larry Nance,C,27,CLE,23,4,591,80,161,.497,26,71,.366,54,90,.600,.578,25,35,.714,44,127,171,33,19,10,23,38,211
Shabazz Napier,PG,28,MIN,13,0,226,27,75,.360,11,48,.229,16,27,.593,.433,21,24,.875,1,23,24,40,14,3,22,15,86
Raul Neto,PG,27,PHI,24,2,290,40,81,.494,15,31,.484,25,50,.500,.586,3,4,.750,3,23,26,37,10,2,21,17,98
Georges Niang,PF,26,UTA,20,0,240,32,67,.478,18,43,.419,14,24,.583,.612,7,10,.700,2,34,36,10,2,3,10,28,89
Jaylen Nowell,SG,20,MIN,2,0,15,1,4,.250,0,3,.000,1,1,1.000,.250,1,1,1.000,0,1,1,3,0,0,1,1,3
Frank Ntilikina,PG,21,NYK,24,20,590,54,146,.370,19,60,.317,35,86,.407,.435,13,17,.765,8,38,46,73,30,10,29,62,140
Kendrick Nunn,SG,24,MIA,25,25,767,161,356,.452,52,151,.344,109,205,.532,.525,31,38,.816,7,59,66,89,27,7,51,65,405
David Nwaba,SF,27,BRK,16,0,202,26,49,.531,8,18,.444,18,31,.581,.612,12,20,.600,7,27,34,5,6,9,6,25,72
Royce O'Neale,PF,26,UTA,26,24,744,57,123,.463,33,74,.446,24,49,.490,.598,12,14,.857,5,115,120,68,21,6,21,77,159
Kyle O'Quinn,C,29,PHI,16,0,164,24,47,.511,6,16,.375,18,31,.581,.574,2,6,.333,19,42,61,23,2,12,16,24,56
Semi Ojeleye,PF,25,BOS,24,1,373,22,55,.400,12,35,.343,10,20,.500,.509,7,10,.700,8,41,49,11,10,2,5,30,63
Jahlil Okafor,C,24,NOP,17,8,309,60,98,.612,1,2,.500,59,96,.615,.617,28,42,.667,29,49,78,29,5,15,26,50,149
Elie Okobo,PG,22,PHO,16,0,152,21,52,.404,10,25,.400,11,27,.407,.500,11,21,.524,2,13,15,38,4,0,4,8,63
Josh Okogie,SG,21,MIN,23,8,586,64,149,.430,19,60,.317,45,89,.506,.493,61,77,.792,32,83,115,36,23,8,35,54,208
Jordan Poole,SG,20,GSW,25,9,585,60,232,.259,30,121,.248,30,111,.270,.323,43,52,.827,4,50,54,52,15,6,29,45,193
Kevin Porter,SF,19,CLE,24,1,505,70,164,.427,20,62,.323,50,102,.490,.488,22,30,.733,8,67,75,47,23,5,38,56,182
Michael Porter,PF,21,DEN,14,0,127,25,56,.446,7,19,.368,18,37,.486,.509,7,10,.700,12,24,36,5,0,3,11,16,64
Otto Porter,SF,26,CHI,9,9,226,35,84,.417,16,40,.400,19,44,.432,.512,15,20,.750,8,23,31,14,9,3,7,20,101
Bobby Portis,C,24,NYK,26,2,564,92,224,.411,25,73,.342,67,151,.444,.467,25,34,.735,39,110,149,30,16,9,25,43,234
Kristaps Porziņģis,PF,24,DAL,23,23,694,137,342,.401,44,135,.326,93,207,.449,.465,63,88,.716,38,162,200,31,12,47,35,68,381
Dwight Powell,C,28,DAL,21,18,537,70,102,.686,6,14,.429,64,88,.727,.716,26,45,.578,33,70,103,26,17,9,19,53,172
Norman Powell,SG,26,TOR,24,13,679,117,247,.474,41,114,.360,76,133,.571,.557,53,64,.828,13,79,92,37,26,8,40,44,328
Julius Randle,PF,25,NYK,26,26,832,163,365,.447,26,96,.271,137,269,.509,.482,98,148,.662,61,166,227,91,18,3,82,73,450
Cam Reddish,SF,20,ATL,23,17,579,67,206,.325,25,92,.272,42,114,.368,.386,34,47,.723,15,75,90,37,20,9,43,43,193
J.J. Redick,SG,35,NOP,25,21,719,122,278,.439,81,179,.453,41,99,.414,.585,70,80,.875,5,71,76,52,11,5,32,41,395
Josh Richardson,SG,26,PHI,19,19,583,103,233,.442,35,90,.389,68,143,.476,.517,42,54,.778,13,50,63,60,21,12,39,51,283
Austin Rivers,SG,27,HOU,23,1,563,67,165,.406,31,96,.323,36,69,.522,.500,20,28,.714,17,43,60,36,11,4,15,46,185
Duncan Robinson,SF,25,MIA,25,20,677,100,209,.478,78,174,.448,22,35,.629,.665,15,16,.938,3,71,74,21,19,9,16,67,293
Glenn Robinson,SF,26,GSW,27,27,869,126,277,.455,32,87,.368,94,190,.495,.513,30,36,.833,41,89,130,46,27,7,24,47,314
Jerome Robinson,SG,22,LAC,22,0,269,30,91,.330,11,43,.256,19,48,.396,.390,5,10,.500,3,32,35,20,7,7,15,31,76
Rajon Rondo,PG,33,LAL,14,0,298,42,96,.438,19,40,.475,23,56,.411,.536,8,11,.727,4,44,48,81,15,1,26,16,111
Derrick Rose,PG,31,DET,20,1,477,129,266,.485,19,53,.358,110,213,.516,.521,47,54,.870,9,29,38,114,17,7,50,21,324
Terrence Ross,SG,28,ORL,23,0,569,105,257,.409,45,140,.321,60,117,.513,.496,45,53,.849,6,58,64,24,23,8,26,39,300
Terry Rozier,PG,25,CHO,28,28,926,170,401,.424,72,182,.396,98,219,.447,.514,67,78,.859,21,112,133,121,33,4,76,62,479
Ricky Rubio,PG,29,PHO,19,19,607,88,226,.389,21,70,.300,67,156,.429,.436,53,63,.841,13,74,87,174,25,3,39,49,250
D'Angelo Russell,SG,23,GSW,15,15,468,120,278,.432,45,131,.344,75,147,.510,.513,51,69,.739,4,50,54,91,14,5,49,32,336
Domantas Sabonis,C,23,IND,24,24,825,171,335,.510,5,26,.192,166,309,.537,.518,84,108,.778,82,243,325,92,20,13,69,89,431
JaKarr Sampson,SF,26,IND,9,7,166,23,41,.561,2,10,.200,21,31,.677,.585,2,7,.286,7,17,24,4,5,6,6,23,50
Dario Šarić,PF,25,PHO,24,24,674,96,224,.429,39,115,.339,57,109,.523,.516,35,41,.854,43,129,172,52,20,10,31,66,266
Tomáš Satoranský,PG,28,CHI,27,27,734,90,206,.437,30,80,.375,60,126,.476,.510,40,46,.870,21,67,88,143,38,3,56,54,250
Admiral Schofield,SF,22,WAS,10,0,76,7,12,.583,4,9,.444,3,3,1.000,.750,4,4,1.000,2,9,11,1,0,0,3,7,22
Dennis Schröder,PG,26,OKC,24,0,706,157,341,.460,38,116,.328,119,225,.529,.516,50,62,.806,8,80,88,81,18,8,63,55,402
Mike Scott,PF,31,PHI,27,3,517,64,145,.441,35,95,.368,29,50,.580,.562,12,15,.800,20,75,95,18,9,2,10,39,175
Thabo Sefolosha,PF,35,HOU,21,0,217,16,46,.348,8,28,.286,8,18,.444,.435,0,1,.000,11,36,47,15,9,4,7,20,40
Collin Sexton,SG,21,CLE,25,25,763,171,389,.440,26,86,.302,145,303,.479,.473,76,93,.817,24,51,75,60,22,1,45,50,444
Landry Shamet,SG,22,LAC,10,10,294,30,77,.390,21,58,.362,9,19,.474,.526,10,10,1.000,0,15,15,17,4,1,12,31,91
Iman Shumpert,SG,29,BRK,13,0,241,21,64,.328,8,33,.242,13,31,.419,.391,4,7,.571,9,25,34,12,12,2,10,21,54
Pascal Siakam,PF,25,TOR,24,24,884,220,481,.457,53,147,.361,167,334,.500,.512,95,116,.819,37,161,198,85,22,19,66,66,588
Chris Silva,PF,23,MIA,23,0,223,31,47,.660,0,2,.000,31,45,.689,.660,26,36,.722,41,45,86,13,5,15,25,57,88
Ben Simmons,PG,23,PHI,25,25,864,145,256,.566,2,5,.400,143,251,.570,.570,60,103,.583,37,134,171,210,54,15,94,82,352
Anfernee Simons,SG,20,POR,26,1,566,98,230,.426,38,110,.345,60,120,.500,.509,32,43,.744,7,43,50,40,12,4,24,52,266
Marcus Smart,SG,25,BOS,20,15,635,82,212,.387,42,126,.333,40,86,.465,.486,29,33,.879,19,48,67,91,26,9,25,46,235
Dennis Smith,PG,22,NYK,17,1,293,34,107,.318,10,33,.303,24,74,.324,.364,14,27,.519,12,21,33,46,7,5,26,37,92
Ish Smith,PG,31,WAS,23,9,581,90,200,.450,21,58,.362,69,142,.486,.503,12,19,.632,11,54,65,100,16,8,28,39,213
Tony Snell,SF,28,DET,21,19,537,60,127,.472,42,91,.462,18,36,.500,.638,4,4,1.000,5,32,37,29,8,2,10,39,166
Omari Spellman,PF,22,GSW,26,0,473,69,159,.434,19,53,.358,50,106,.472,.494,37,44,.841,56,86,142,26,16,16,36,27,194
Max Strus,SG,23,CHI,2,0,6,2,3,.667,0,1,.000,2,2,1.000,.667,1,1,1.000,1,0,1,0,0,0,0,1,5
Edmond Sumner,PG,24,IND,4,2,72,9,19,.474,0,3,.000,9,16,.563,.474,3,5,.600,1,2,3,8,5,1,1,9,21
Caleb Swanigan,PF,22,SAC,4,0,11,1,2,.500,0,0,0,1,2,.500,.500,1,2,.500,1,3,4,0,1,2,3,3,3
Jayson Tatum,PF,21,BOS,24,24,821,177,436,.406,60,165,.364,117,271,.432,.475,81,97,.835,28,139,167,69,34,18,53,55,495
Jeff Teague,PG,31,MIN,21,12,623,96,206,.466,21,55,.382,75,151,.497,.517,90,103,.874,12,47,59,143,19,7,45,44,303
Garrett Temple,SG,33,BRK,24,15,670,88,211,.417,52,146,.356,36,65,.554,.540,19,25,.760,13,63,76,57,23,13,26,47,247
Daniel Theis,C,27,BOS,21,20,459,63,118,.534,7,21,.333,56,97,.577,.564,22,32,.688,34,98,132,27,9,32,17,66,155
Isaiah Thomas,PG,30,WAS,17,14,424,82,184,.446,34,83,.410,48,101,.475,.538,16,20,.800,3,28,31,86,8,4,37,37,214
Khyri Thomas,SG,23,DET,2,0,6,0,0,0,0,0,0,0,0,0,0,1,2,.500,0,0,0,0,0,0,0,0,1
Matt Thomas,SG,25,TOR,12,0,136,20,37,.541,14,26,.538,6,11,.545,.730,3,5,.600,1,12,13,4,4,0,4,12,57
Tristan Thompson,C,28,CLE,24,24,746,135,263,.513,3,7,.429,132,256,.516,.519,43,78,.551,95,141,236,56,20,27,42,60,316
Matisse Thybulle,SG,22,PHI,26,3,466,44,100,.440,28,60,.467,16,40,.400,.580,15,20,.750,8,24,32,34,37,19,25,58,131
Anthony Tolliver,PF,34,POR,18,7,287,18,61,.295,14,48,.292,4,13,.308,.410,9,11,.818,10,45,55,11,4,6,11,23,59
Karl-Anthony Towns,C,24,MIN,23,23,779,207,403,.514,82,196,.418,125,207,.604,.615,113,142,.796,63,206,269,101,24,29,72,80,609
Allonzo Trier,PG,24,NYK,12,1,157,28,55,.509,14,32,.438,14,23,.609,.636,26,33,.788,1,16,17,16,2,3,17,22,96
P.J. Tucker,PF,34,HOU,25,25,893,88,175,.503,50,114,.439,38,61,.623,.646,19,24,.792,38,142,180,35,34,12,28,85,245
Evan Turner,PG,31,ATL,15,0,208,23,59,.390,0,5,.000,23,54,.426,.390,12,14,.857,7,25,32,33,8,8,23,16,58
Myles Turner,C,23,IND,18,18,542,72,170,.424,24,73,.329,48,97,.495,.494,28,38,.737,27,72,99,21,11,40,30,46,196
Jonas Valančiūnas,C,27,MEM,23,23,565,131,234,.560,13,33,.394,118,201,.587,.588,38,50,.760,57,164,221,44,8,18,50,65,313
Denzel Valentine,SF,26,CHI,13,0,161,33,74,.446,19,46,.413,14,28,.500,.574,3,3,1.000,3,24,27,18,9,4,6,16,88
Fred VanVleet,PG,25,TOR,22,22,806,126,308,.409,58,147,.395,68,161,.422,.503,85,97,.876,4,79,83,155,44,3,52,51,395
Noah Vonleh,C,24,MIN,16,1,181,20,43,.465,1,10,.100,19,33,.576,.477,16,19,.842,18,36,54,16,4,3,13,20,57
Nikola Vučević,C,29,ORL,14,14,431,95,211,.450,16,50,.320,79,161,.491,.488,33,39,.846,41,121,162,49,9,15,20,27,239
Dean Wade,PF,23,CLE,3,0,18,1,2,.500,1,1,1.000,0,1,.000,.750,0,0,0,0,2,2,0,1,0,0,3,3
Moritz Wagner,C,22,WAS,21,4,429,93,160,.581,22,56,.393,71,104,.683,.650,36,43,.837,34,93,127,28,15,13,43,81,244
Kemba Walker,PG,29,BOS,23,23,742,174,406,.429,87,214,.407,87,192,.453,.536,96,108,.889,21,76,97,122,22,13,49,39,531
Lonnie Walker,SG,21,SAS,17,0,152,31,67,.463,6,16,.375,25,51,.490,.507,7,15,.467,6,17,23,8,5,3,8,13,75
Tyrone Wallace,SG,25,ATL,14,0,160,14,44,.318,1,15,.067,13,29,.448,.330,11,17,.647,3,19,22,13,7,1,10,19,40
Taurean Waller-Prince,SF,25,BRK,24,24,735,113,284,.398,64,163,.393,49,121,.405,.511,24,33,.727,19,128,147,54,21,9,51,63,314
Derrick Walton,PG,24,LAC,11,0,98,7,13,.538,4,9,.444,3,4,.750,.692,6,7,.857,2,3,5,8,3,0,1,9,24
Brad Wanamaker,PG,30,BOS,24,0,430,57,121,.471,12,30,.400,45,91,.495,.521,48,55,.873,11,38,49,67,17,6,29,41,174
T.J. Warren,SF,26,IND,26,26,853,190,375,.507,33,84,.393,157,291,.540,.551,61,75,.813,18,71,89,27,29,7,37,74,474
PJ Washington,PF,21,CHO,28,28,823,127,264,.481,39,96,.406,88,168,.524,.555,50,71,.704,26,121,147,49,28,26,38,78,343
Tremont Waters,PG,22,BOS,1,0,20,2,7,.286,1,5,.200,1,2,.500,.357,2,2,1.000,0,2,2,3,1,2,2,2,7
Russell Westbrook,PG,31,HOU,23,23,794,193,454,.425,27,116,.233,166,338,.491,.455,104,137,.759,37,147,184,169,38,8,100,89,517
Coby White,SG,19,CHI,27,0,678,115,320,.359,52,156,.333,63,164,.384,.441,38,48,.792,8,90,98,67,20,1,40,37,320
Derrick White,SG,25,SAS,22,10,533,78,166,.470,20,51,.392,58,115,.504,.530,44,55,.800,11,41,52,63,10,15,26,53,220
Hassan Whiteside,C,30,POR,23,23,653,154,249,.618,1,1,1.000,153,248,.617,.620,63,82,.768,84,202,286,32,10,56,43,68,372
Andrew Wiggins,SF,24,MIN,21,21,735,197,427,.461,46,138,.333,151,289,.522,.515,85,114,.746,26,81,107,69,15,24,43,51,525
Grant Williams,PF,21,BOS,22,1,308,15,60,.250,1,26,.038,14,34,.412,.258,14,17,.824,15,34,49,18,8,12,17,44,45
Kenrich Williams,PF,25,NOP,24,14,606,45,115,.391,22,76,.289,23,39,.590,.487,9,22,.409,38,102,140,43,20,17,18,64,121
Lou Williams,SG,33,LAC,26,3,807,170,413,.412,45,129,.349,125,284,.440,.466,133,158,.842,12,72,84,162,14,4,80,41,518
Marvin Williams,PF,33,CHO,24,0,487,63,127,.496,30,75,.400,33,52,.635,.614,27,30,.900,9,57,66,23,16,10,16,40,183
Robert Williams,C,22,BOS,19,1,269,33,49,.673,0,0,0,33,49,.673,.673,8,14,.571,23,64,87,21,17,21,16,34,74
Nigel Williams-Goss,PG,25,UTA,7,0,22,0,5,.000,0,1,.000,0,4,.000,.000,2,2,1.000,1,1,2,2,0,1,1,1,2
D.J. Wilson,PF,23,MIL,13,0,159,28,55,.509,11,34,.324,17,21,.810,.609,1,1,1.000,5,25,30,11,0,1,7,14,68
Justise Winslow,SF,23,MIA,10,5,337,50,127,.394,6,26,.231,44,101,.436,.417,18,27,.667,16,55,71,43,6,4,23,36,124
Christian Wood,PF,24,DET,23,0,344,77,121,.636,15,31,.484,62,90,.689,.698,38,57,.667,28,79,107,12,7,19,22,22,207
Delon Wright,SG,27,DAL,22,2,466,62,129,.481,13,37,.351,49,92,.533,.531,28,34,.824,17,58,75,74,25,7,15,27,165
Thaddeus Young,PF,31,CHI,26,0,567,95,232,.409,28,84,.333,67,148,.453,.470,17,30,.567,40,74,114,45,26,7,41,43,235
Trae Young,PG,21,ATL,25,25,871,228,513,.444,83,223,.372,145,290,.500,.525,153,178,.860,13,91,104,215,30,2,121,38,692
Cody Zeller,C,27,CHO,25,17,584,113,209,.541,15,45,.333,98,164,.598,.577,42,61,.689,71,123,194,30,14,11,39,61,283
Ivica Zubac,C,22,LAC,27,25,451,85,144,.590,0,2,.000,85,142,.599,.590,53,65,.815,64,117,181,24,5,30,24,64,223
